...###
..##.#.####
.##..###..#
##........#
#...#..#..#
###..###..#
..#..#....#
.##.##.#.##
.#..#....##
.#...##..##
@.######